#################             #################
#               #             #               #
#               #             #               #
#               #             #               #
#               #######       #               #
#   @                 #       #               #
#               ###   #########               #
#               ###                           #
#               # #############               #
#               # #############               #
########   ######             #################
       #   #
       #   #
       #   #             #################
       #   #             #               #
       #   #             #           +   #
       #   #             #               #
       #   #             #               #
       #   ###############               #
       #                                 #
       #                                 #
       #   ###############               #
       #   #             #               #
       #   #             #               #
       #####             #################