######################
#                    #
#                    #
#                    #
#                    #
#    e               #
########## ###########
#                    #
#                    #
#                    #
#                    #
#         @          #
######################