######################
#                    #
#                    #
#                    #
#                    #
#                    #
#                    #
#   @     #          #
#                    #
#                    #
#                    #
#                    #
#                    #
#                    #
######################