######################
#         #          #
#                    #
#                    #
#                    #
#                    #
#                    #
#   #     @     #    #
#                    #
#                    #
#                    #
#                    #
#                    #
#         #          #
######################