#################
#               #
#               #
#               #
#               #
#   @#          #
#               #
#               #
#               #
#               #
#################