######################
#                    #
#                    #
#                    #
#                    #
#                    #
########## ###########
#                    #
#                    #
#                    #
#                    #
#         @          #
######################