#############################################
#############################################
#############################################
#####               #########################
#####               #########################
#####               #########################
#####                                       ++
#####                                       ++
#####                            ############
#####@                           ############
#####################            ############
#####                            ############
#####                            ############
#####                            ############
#####                            ############
#####                            ############
#####                            ############
#####                            ############
#####                            ############
#####                            ############
#####                            ############
#############################################
#############################################
#############################################
#############################################