┌───────────────┐
│               │
│               │
│               │
│               │
│               │
│               │
│               │
│@              │
└───────────────┘