                                                                                
              ******************                 ******************.            
          ******/     %%%    .******         /*****/             ******/        
       *****  ,                   *****    ****/                     *****      
     /***/ ,                        *********                           ****    
    **** .                            /****                               ***#  
   ***,            (                   ,**                                 **** 
  ***/                                                                      *** 
  *** /                                                                     ***.
  ***                                                                       /***
  ***                                                                       ***,
  *****                                                                     *** 
   *** .        @                                                          ***( 
    ***.(                                                                 ***#  
     ****(                                                              (***(   
      **** ,                                                           ****     
        ****        #                                                ****       
          *****                                                   *****         
            ***** &    .                                        *****           
               ****(                                         /****              
                 ,****                                    /****                 
                    /****(  .                           *****                   
                       *****  ,                      *****                      
                          ****/ &                 /****                         
                            .**** /             ****(                           
                               ****(.        ,****                              
                                 (****     ,****                                
                                   /**** *****                                  
                                     ,******                                    
                                       /**                                      
