#################
#               #
#               #
#               #
#               #
#               #
#               #
#               #
#@              #
#################